###############
#333x33#444444#
#333#33#444444#
#333333xx#4444#
#333333#444444#
#333333#444444#
###x#######D###
#1111##2222222#
#11111#2222#22#
#11111D2222222#
#11111#2222222#
#11111#2222222#
###############