############
#----------#
#--######--#
#----------#
#--######--#
#----------#
#--######--#
#----------#
#--######--#
#----------#
#--######--#
#----------#
############